XXXXXXXXXXXX
X....@.X...X
X..XX.XX.M.X
X..X...X...X
X..X.......X
XM.X...X.M.X
X.MX...X...X
XXXXXXXXXXXX
